10
███ ██████
█   ██   █
█ █    █ █
█ ██████ █
█ █      █
█ █ █ ████
█ █ █    █
█ █ ████ █
█      █ █
██████ ███